{
  ",": ",",
  ".": ".",
  ";": ";",
  "A": "A",
  "B": "B",
  "C": "C",
  "D": "D",
  "E": "E",
  "F": "F",
  "G": "G",
  "H": "H",
  "I": "I",
  "J": "J",
  "L": "L",
  "M": "M",
  "N": "N",
  "P": "P",
  "Q": "Q",
  "R": "R",
  "S": "S",
  "T": "T",
  "U": "U",
  "V": "V",
  "W": "W",
  "X": "X",
  "Y": "Y",
  "’": "'",
  " ": " "
}