{
  ",": ",",
  ".": ".",
  ";": ";",
  "A": "c",
  "B": "i",
  "C": "o",
  "D": "D",
  "E": "y",
  "F": "b",
  "G": "l",
  "I": "f",
  "J": "t",
  "L": "m",
  "M": "a",
  "N": "d",
  "P": "h",
  "Q": "p",
  "R": "s",
  "S": "S",
  "T": "n",
  "U": "u",
  "V": "r",
  "W": "g",
  "X": "e",
  "Y": "W",
  "’": "'",
  " ": " "
}